0,0,0,0,0,0,0,0,0,0,0
0,3,1,1,1,3,3,3,1,3,0
0,1,1,3,1,1,1,3,1,3,0
2,1,3,3,1,3,1,3,1,3,0
0,1,1,3,1,3,1,1,1,3,0
0,3,1,1,1,3,1,3,1,4,0
0,0,0,0,0,0,0,0,0,0,0